00000000000000000000000000000000000000000000000000000000000000000000000000000000000000000000000000000000000000000000000000000000000000000000000000000000000000000000000000000000
00000000000000000000000000000000000000000000000000000000000000000000000000000000000000000000000000000000000000000000000000000000000000000000000000000000000000000000000000000000
00000000000000000000000000000000000000000000000000000000000000000000000000000000000000000000000000000000000000000000000000000000000000000000000000000000000000000000000000000000
00000000000000000000000000000000000000000000000000000000000000000000000000000000000000000000000000000000000000000000000000000000000000000000000000000000000000000000000000000000
00000000000000000000000000000000000000000000000000000000000000000000000000000000000000000000000000000000000000000000000000000000000000000000000000000000000000000000000000000000
00000111111111111111111111111111111111111111111111111111111111111111111111111111111111111111111111111111111111111111111111111111111111111111111111111111111111111111111111100000
00000100000000000000000000000000000000000000000000000000000000000000000000000000000000000000000000000000000000000000000000000000000000000000000000000000000000000000000000100000
00000100000000000000000000000000000000000000000000000000000000000000000000000000000000000000000000000000000000000000000000000000000000000000000000000000000000000000000000100000
00000100000000000000000000000000000000000000000000000000000000000000000000000000000000000000000000000000000000000000000000000000000000000000000000000000000000000000000000100000
00000100000000000000000000000000000000000000000000000000000000000000000000000000000000000000000000000000000000000000000000000000000000000000000000000000000000000000000000100000
00000100000000000000000000000000000000000000000000000000000000000000000000000000000000000000000000000000000000000000000000000000000000000000000000000000000000000000000000100000
00000100000000000000000000000000000000000000000000000000000000000000000000000000000000000000000000000000000000000000000000000000000000000000000000000000000000000000000000100000
00000100000000000000000000000000000000000000000000000000000000000000000000000000000000000000000000000000000000000000000000000000000000000000000000000000000000000000000000100000
00000100000000000000000000000000000000000000000000000000000000000000000000000000000000000000000000000000000000000000000000000000000000000000000000000000000000000000000000100000
00000100000000000000000000000000000000000000000000000000000000000000000000000000000000000000000000000000000000000000000000000000000000000000000000000000000000000000000000100000
00000100000000000000000000000000000000000000000000000000000000000000000000000000000000000000000000000000000000000000000000000000000000000000000000000000000000000000000000100000
00000100000000000000000000000000000000000000000000000000000000000000000000000000000000000000000000000000000000000000000000000000000000000000000000000000000000000000000000100000
00000100000000000000000000000000000000000000000000000000000000000111111111111111111111110000111111111111111111111110000000000000000000000000000000000000000000000000000000100000
00000100000000000000000000000000000000000000000000000000000000000100000000000000000010000000000100000000000000000010000000000000000000000000000000000000000000000000000000100000
00000100000000000000000000000000000000000000000000000000000000000100000000000000000010000000000100000000000000000010000000000000000000000000000000000000000000000000000000100000
00000100000000000000000000000000000000000000000000000000000000000100000000000000000010000000000100000000000000000010000000000000000000000000000000000000000000000000000000100000
00000100000000000000000000000000000000000000000000000000000000000100110000000000000010000000000100000000000000000010000000000000000000000000000000000000000000000000000000100000
00000100000000000000000000000000000000000000000000000000000000000100110000000000000010000000000000000000000000000010000000000000000000000000000000000000000000000000000000100000
00000100000000000000000000000000000000000000000000000000000000000100000000000000000010000000000000000000000000000010000000000000000000000000000000000000000000000000000000100000
00000100000000000000000000000000000000000000000000000000000000000100000000000000000010000000000100000000000000000010000000000000000000000000000000000000000000000000000000100000
00000100000000000000000000000000000000000000000000000000000000000100110000000000000010000000000100000000000000000010000000000000000000000000010000000000000000000000000000100000
00000100000000000000000000000000000000000000000000000000000000000100110000000000000000000000000100000000000000000010000000000000000000000100000000000000000000000000000000100000
00000100000000000000000000000000000000000000000000000000000000000100000000000000000000000000000100000000000000000010000000000000000000000100000000000000000000000000000000100000
00000100000000000000000000000000000000000000000000000000000000000100000000000000000010000000000100000000000000000010000000000000000000000100000000000000000000000000000000100000
00000100000000000000000000000000000000000000000000000000000000000100000000000000000010000000000111111111111111111110000000000000000000000100000000000000000000010000000000100000
00000100000000000000000000000000000000000000000000000000000000000100000000000000000010000000000100000000000000000010000000000000000000000100000000000000000000000000000000100000
00000100000000000000000000000000000000000000000000000000000000000100110000000000000010000000000100000000000000000010000000000000000000000100000000000000000000000000000000100000
00000100000000000000000000000000000000000000000000000000000000000100110000000000000010000000000100000000000000000010000000000000000000000100000000000000000000000000000000100000
00000100000000000000000000000000000000000000000000000000000000000100000000000000000010000000000100000000000000000010000000000000000000000100000000000000000000000000000000100000
00000100000000000000000000000000000000000000000000000000000000000100000000000000000010000000000000000000000000000010000000000000000000000100000000000000000000000000000000100000
00000100000000000000000000000000000000000000000000000000000000000100110000000000000010000000000000000000000000000010000000000000000000000000000000000000000000000000000000100000
00000100000000000000000000000000000000000000000000000000000000000100110000000000000010000000000100000000000000000010000000000000000000000000000000000000000000000000000000100000
00000100000000000000000000000000000000000000000000000000000000000100000000000000000010000000000100000000000000000010000000000000000000000000000000000000000000000000000000100000
00000100000000000000000000000000000000000000000000000000000000000100000000000000000010000000000100000000000000000010000000000000000000000000000000000000000000000000000000100000
00000100000000000000000000000000000000000000000000000000000000000100000000000000000010000000000100000000000000000010000000000000000000000000000000000000000000000000000000100000
00000100000000000000000000000000000000000000000000000000000000000111111111111111111111111001111111111111111111111110000000000000000000000000000000000000000000000000000000100000
00000100000000000000000000000000000000000000000000000000000000000000000000000000000000000000000000000000000000000000000000000000000000000000000000000000000000000000000000100000
00000100000000000000000000000000000000000000000000000000000000000000000000000000000000000000000000000000000000000000000000000000000000000000000000000000000000000000000000100000
00000100000000000000000000000000000000000000000000000000000000000000000000000000000000000000000000000000000000000000000000000000000000000000000000000000000000000000000000100000
00000100000000000000000000000000000000000000000000000000000000000000000000000000000000000000000000000000000000000000000000000000000000000000000000000000000000000000000000100000
00000100000000000000000000000000000000000000000000000000000000000000000000000000000000000000000000000000000000000000000000000000000000000000000000000000000000000000000000100000
00000100000000000000000000000000000000000000000000000000000000000000000000000000000000000000000000000000000000000000000000000000000000000000000000000000000000000000000000100000
00000100000000000000000000000000000000000000000000000000000000000000000000000000000000000000000000000000000000000000000000000000000000000000000000000000000000000000000000100000
00000100000000000000000000000000000000000000000000000000000000000000000000000000000000000000000000000000000000000000000000000000000000000000000000000000000000000000000000100000
00000100000000000000000000000000000000000000000000000000000000000000000000000000000000000000000000000000000000000000000000000000000000000000000000000000000000000000000000100000
00000100000000000000000000000000000000000000000000000000000000000000000000000000000000000000000000000000000000000000000000000000000000000000000000000000000000000000000000100000
00000100000000000000000000000000000000000000000000000000000000000000000000000000000000000000000000000000000000000000000000000000000000000000000000000000000000000000000000100000
00000100000000000000000000000000000000000000000000000000000000000000000000000000000000000000000000000000000000000000000000000000000000000000000000000000000000000000000000100000
00000111111111111111111111111111111111111111111111111111111111111111111111111111111111111111111111111111111111111111111111111111111111111111111111111111111111111111111111100000
00000000000000000000000000000000000000000000000000000000000000000000000000000000000000000000000000000000000000000000000000000000000000000000000000000000000000000000000000000000
00000000000000000000000000000000000000000000000000000000000000000000000000000000000000000000000000000000000000000000000000000000000000000000000000000000000000000000000000000000
00000000000000000000000000000000000000000000000000000000000000000000000000000000000000000000000000000000000000000000000000000000000000000000000000000000000000000000000000000000
00000000000000000000000000000000000000000000000000000000000000000000000000000000000000000000000000000000000000000000000000000000000000000000000000000000000000000000000000000000
00000000000000000000000000000000000000000000000000000000000000000000000000000000000000000000000000000000000000000000000000000000000000000000000000000000000000000000000000000000