==========================================================================================
==========================================================================================
==========================================================================================
==========================================================================================
==========================================================================================
==========================================================================================
==========================================================================================
==========================================================================================
============================================;;============================================
=================================.........;;;;;;.........=================================
=================================....$....;;;;;;.........=================================
=================================.........;;;;;;...$.....=================================
=================================.........;;;;;;.........=================================
=================================....$....;;;;;;..$......=================================
========$$$$$$$$$================.........;;;;;;.........=================================
========$$$$$$$$$================.........;;;;;;...$.....=============P===================
========$$$$$$$$$================....$....;;;;;;.........=================================
========$$$$$$$$$================.........;;;;;;.........=================================
========$$$$$$$$$================.........;;;;;;.........=================================
========$$$$$$$$$================.........;;;;;;.........=================================
========$$$$$$$$$=========================================================================
==========================================================================================
==========================================================================================
==========================================================================================
==========================================================================================
==========================================================================================
==========================================================================================
==========================================================================================
==========================================================================================