==========================================================================================
==========================================================================================
==========================================================================================
==========================================================================================
==========================================================================================
==========================================================================================
==========================================================================================
==========================================================================================
============================================P=============================================
=================================.........;;;;;;.........=================================
=================================.........;;;;;;.........=================================
=================================.........;;;;;;.........=================================
=================================.........;;;;;;.........=================================
=================================.........;;;;;;.........=================================
=================================.........;;;;;;.........=================================
=================================.........;;;;;;.........=================================
=================================.........;;;;;;.........=================================
=================================.........;;;;;;.........=================================
=================================.........;;;;;;.........=================================
=================================.........;;;;;;.........=================================
==========================================================================================
==========================================================================================
==========================================================================================
==========================================================================================
==========================================================================================
==========================================================================================
==========================================================================================
==========================================================================================
==========================================================================================