0000000000000000000000000000000000000000000000000000000000000000000000000000000000
0111111111111111111111111111111111111111111111111111111111111111111111111111111110
0100000000000000000000000000000000000000000000000000000000000000000000000000000010
0100000000000000000000000000000000000000000000000000000000000000000000000000000010
0100000000000000000000000000000000000000000000000000000000000000000000000000000010
0100000000000000000000000000000000000000000000000000000000000000000000000000000010
0100000000000000000000000000000000000000000000000000000000000000000000000000000010
0100000000000000000000000000000000000000000000000000000000000000000000000000000010
0100000000000000000000000000000000000000000000000000000000000000000000000000000010
0100000000000000000000000000000000000000000000000000000000000000000000000000000010
0100000000000000000000000000000000000000000000000000000000000000000000000000000010
0100000000000000000000000000000000000000000000000000000000000000000000000000000010
0100000000000000000000000000000000000000000000000000000000000000000000000000000010
0100000000000111111111111111111111111111001111111111111111111111111110000000000010
0100000000000100000000000000000100000000000000000010000000000000000010000000000010
0100000000000100000000000000000100000000000000000010000000000000000010000000000010
0100000000000100000000000000000100000000000000000010000000000000000010000000000010
0100000000000100000000000000000100000000000000000010000000000000000010000000000010
0100000000000100000000000000000000000000000000000000000000000000000010000000000010
0100000000000100000000000000000000000000000000000000000000000000000010000000000010
0100000000000100000000000000000000000000000000000000000000000000000010000000000010
0100000000000100000000000000000100000000000000000010000000000000000010000000000010
0100000000000100000000000000000100000000000000000010000000000000000010000000000010
0100000000000100000000000000000100000000000000000010000000000000000010000000000010
0100000000000100000000000000000100000000000000000010000000000000000010000000000010
0100000000000111111111111111111111111100000011111111111111110011111110000000000010
0100000000000100000000000000100000000000000000000000010000000000000010000000000010
0100000000000100000000000000100000000000000000000000010000000000000010000000000010
0100000000000100000000000000100000000000000000000000010000000000000010000000000010
0100000000000100000000000000100000000000000000000000010000000000000010000000000010
0100000000000100000000000000100000000000000000000000010000000000000010000000000010
0100000000000100000000000000100000000000000000000000010000000000000010000000000010
0100000000000100000000000000100000000000000000000000010000000000000010000000000010
0100000000000100000000000000100000000000000000000000010000000000000010000000000010
0100000000000100000000000000100000000000000000000000010000000000000010000000000010
0100000000000100000000000000100000000000000000000000010000000000000010000000000010
0100000000000100000000000000100000000000000000000000010000000000000010000000000010
0100000000000100000000000000100000000000000000000000010000000000000010000000000010
0100000000000100000000000000100000000000000000000000010000000000000010000000000010
0100000000000100000000000000100000000000000000000000010000000000000010000000000010
0100000000000111110011111111111111111100000011111111111111110011111110000000000010
0100000000000100000000000000000100000000000000000010000000000000000010000000000010
0100000000000100000000000000000100000000000000000010000000000000000010000000000010
0100000000000100000000000000000100000000000000000010000000000000000010000000000010
0100000000000100000000000000000100000000000000000010000000000000000010000000000010
0100000000000100000000000000000000000000000000000010000000000000000010000000000010
0100000000000100000000000000000000000000000000000010000000000000000010000000000010
0100000000000100000000000000000000000000000000000010000000000000000010000000000010
0100000000000100000000000000000100000000000000000010000000000000000010000000000010
0100000000000100000000000000000100000000000000000010000000000000000010000000000010
0100000000000100000000000000000100000000000000000010000000000000000010000000000010
0100000000000100000000000000000100000000000000000010000000000000000010000000000010
0100000000000111111111111111111111111111001111111111111111111111111110000000000010
0100000000000000000000000000000000000000000000000000000000000000000000000000000010
0100000000000000000000000000000000000000000000000000000000000000000000000000000010
0100000000000000000000000000000000000000000000000000000000000000000000000000000010
0100000000000000000000000000000000000000000000000000000000000000000000000000000010
0100000000000000000000000000000000000000000000000000000000000000000000000000000010
0100000000000000000000000000000000000000000000000000000000000000000000000000000010
0100000000000000000000000000000000000000000000000000000000000000000000000000000010
0100000000000000000000000000000000000000000000000000000000000000000000000000000010
0100000000000000000000000000000000000000000000000000000000000000000000000000000010
0100000000000000000000000000000000000000000000000000000000000000000000000000000010
0100000000000000000000000000000000000000000000000000000000000000000000000000000010
0111111111111111111111111111111111111111111111111111111111111111111111111111111110
0000000000000000000000000000000000000000000000000000000000000000000000000000000000
0000000000000000000000000000000000000000000000000000000000000000000000000000000000