==========================================================================================
==========================================================================================
==========================================================================================
==========================================================================================
==========================================================================================
==========================================================================================
==========================================================================================
==========================================================================================
============================================;;============================================
=================================.........;;;;;;.........=================================
=================================....$....;;;;;;.........=================================
=================================.........;;;;;;...$.....=================================
=================================.........;;;;;;.........=================================
=================================....$....;;;;;;..$......=================================
=================================.........;;;;;;.........=================================
=================================.........;;;;;;...$.....=============P===================
=================================....$....;;;;;;.........=================================
=================================.........;;;;;;.........=================================
=================================.........;;;;;;.........=================================
=================================.........;;;;;;.........=================================
==========================================================================================
==========================================================================================
==========================================================================================
==========================================================================================
==========================================================================================
==========================================================================================
==========================================================================================
==========================================================================================
==========================================================================================