00000000000000000000000000000000000000000000000000000000
00000000000000000000000000000000000000000000000000000000
00000000000000000000000000000000000000000000000000000000
00000111111111111111111111110000111111111111111111111110
00000100000000000000000010000000000100000000000000000010
00000100000000000000000010000000000100000000000000000010
00000100000000000000000010000000000100000000000000000010
00000100000000000000000010000000000100000000000000000010
00000100000000000000000010000000000000000000000000000010
00000100000011000000000010000000000000000000000000000010
00000100000011000000000010000000000100000000000000000010
00000100000000000000000010000000000100000000000000000010
00000100000000000000000000000000000100000000000000000010
00000100000000000000000000000000000100000000000000000010
00000100000000000000000010000000000100000000000000000010
00000100000000000000000010000000000111111111111111111110
00000100000000000000000010000000000100000000000000000010
00000100000000000000000010000000000100000000000000000010
00000100000000000000000010000000000100000000000000000010
00000100000000000000000010000000000100000000000000000010
00000100000000000000000010000000000000000000000000000010
00000100000000000000000010000000000000000000000000000010
00000100000000000000000010000000000100000000000000000010
00000100000000000000000010000000000100000000000000000010
00000100000000000000000010000000000100000000000000000010
00000100000000000000000010000000000100000000000000000010
00000111111111111111111111111111111111111111111111111110
00000000000000000000000000000000000000000000000000000000