00000000000000000000000000000000000000000000000000000000
01111111111111111111111111111011111111111111111111111110
01..........................1011111111111111111111111110
01..........................1011111111111111111111111110
01..11111..111..111..11111..1011111111111111111111111110
01..1....................1..1011111111111111111111111110
01..1....................1..1011111111111111111111111110
01..1..111..11..11..111..1..1011111111111111111111111110
01..1..1..............1..1..1011111111111111111111111110
01..1..1..............1..1..101111111.11111111.111111110
01..1..1..1..1111..1..1..1..1011111111........1111111110
01..1..1..1..1111..1..1..1..1011111111........1111111110
01..1..1..............1..1..1011111111........1111111110
01..1..1..............1..1..101111111.11111111.111111110
01..1..111..11..11..111..1..1011111111111111111111111110
01..1....................1..1011111111111111111111111110
01..1....................1..1011111111111111111111111110
01..11111..111..111..11111..1011111111111111111111111110
01..........................1011111111111111111111111110
01..........................1011111111111111111111111110
01111111111111111111111111111011111111111111111111111110
00000000000000000000000000000000000000000000000000000000