=========================================
=========================================
=========================================
=========================================
=========================================
=========================================
=========================================
=======;;;;;;;;;.........;;;;;;;;;=======
=======;;;;;;;;;.........;;;;;;;;;=======
=======;;;;;;;;;.........;;;;;;;;;=======
=======;;;;;;;;;.........;;;;;;;;;=======
=======;;;;;;;;;.........;;;;;;;;;=======
=======;;;;;;;;;.........;;;;;;;;;=======
=======...........................=======
=======...........................=======
=======............===............=======
=======............=P=............=======
=======............===............=======
=======...........................=======
=======...........................=======
=======;;;;;;;;;.........;;;;;;;;;=======
=======;;;;;;;;;.........;;;;;;;;;=======
=======;;;;;;;;;.........;;;;;;;;;=======
=======;;;;;;;;;.........;;;;;;;;;=======
=======;;;;;;;;;.........;;;;;;;;;=======
=======;;;;;;;;;.........;;;;;;;;;=======
=========================================
=========================================
=========================================
=========================================
=========================================
=========================================
=========================================