0000000000000000000000000000000000000000000000000000000000000000000000000000000000
0000000000000000000000000000000000000000000000000000000000000000000000000000000000
0000000000000000000000000000000000000000000000000000000000000000000000000000000000
0000000000000000000000000000000000000000000000000000000000000000000000000000000000
0000000000000000000000000000000000000000000000000000000000000000000000000000000000
0000000000000000000000000000000000000000000000000000000000000000000000000000000000
0000000000000000000000000000000000000000000000000000000000000000000000000000000000
0000000000000000000000000000000000000000000000000000000000000000000000000000000000
0000000000000000000000000000000000000000000000000000000000000000000000000000000000
0000000000000000000000000000000000000000000000000000000000000000000000000000000000
0000000000000000000000000000000000000000000000000000000000000000000000000000000000
0000000000000000000000000000000000000000000000000000000000000000000000000000000000
0000000000000000000000000000000000000000000000000000000000000000000000000000000000
0000000000000111111111111111111111111111111111111111111111111111111110000000000000
0000000000000100000000000000000100000000000000000010000000000000000010000000000000
0000000000000100000000000000000100000000000000000010000000000000000010000000000000
0000000000000100000000000000000100000000000000000010000000000000000010000000000000
0000000000000100000000000000000100000000000000000010000000000000000010000000000000
0000000000000100000000000000000000000000000000000000000000000000000010000000000000
0000000000000100000000000000000000000000000000000000000000000000000010000000000000
0000000000000100000000000000000000000000000000000000000000000000000010000000000000
0000000000000100000000000000000100000000000000000010000000000000000010000000000000
0000000000000100000000000000000100000000000000000010000000000000000010000000000000
0000000000000100000000000000000100000000000000000010000000000000000010000000000000
0000000000000100000000000000000100000000000000000010000000000000000010000000000000
0000000000000111111111111111111111111100000011111111111111110011111110000000000000
0000000000000100000000000000100000000000000000000000010000000000000010000000000000
0000000000000100000000000000100000000000000000000000010000000000000010000000000000
0000000000000100000000000000100000000000000000000000010000000000000010000000000000
0000000000000100000000000000100000000000000000000000010000000000000010000000000000
0000000000000100000000000000100000000000000000000000010000000000000010000000000000
0000000000000100000000000000100000000000000000000000010000000000000010000000000000
0000000000000100000000000000100000000000000000000000010000000000000010000000000000
0000000000000100000000000000100000000000000000000000010000000000000010000000000000
0000000000000100000000000000100000000000000000000000010000000000000010000000000000
0000000000000100000000000000100000000000000000000000010000000000000010000000000000
0000000000000100000000000000100000000000000000000000010000000000000010000000000000
0000000000000100000000000000100000000000000000000000010000000000000010000000000000
0000000000000100000000000000100000000000000000000000010000000000000010000000000000
0000000000000100000000000000100000000000000000000000010000000000000010000000000000
0000000000000111110011111111111111111100000011111111111111110011111110000000000000
0000000000000100000000000000000100000000000000000010000000000000000010000000000000
0000000000000100000000000000000100000000000000000010000000000000000010000000000000
0000000000000100000000000000000100000000000000000010000000000000000010000000000000
0000000000000100000000000000000100000000000000000010000000000000000010000000000000
0000000000000100000000000000000000000000000000000010000000000000000010000000000000
0000000000000100000000000000000000000000000000000010000000000000000010000000000000
0000000000000100000000000000000000000000000000000010000000000000000010000000000000
0000000000000100000000000000000100000000000000000010000000000000000010000000000000
0000000000000100000000000000000100000000000000000010000000000000000010000000000000
0000000000000100000000000000000100000000000000000010000000000000000010000000000000
0000000000000100000000000000000100000000000000000010000000000000000010000000000000
0000000000000111111111111111111111111111111111111111111111111111111110000000000000
0000000000000000000000000000000000000000000000000000000000000000000000000000000000